

  EA ./textures/ETEX.xpm
NO      ./textures/NTEX.xpm  
WE ./textures/WTEX.xpm
       SO ./textures/tommitexture.xpm

F 255,255,255
C 0,0  , 00

1111111111
1100000011
1100S00011
1100000011
1111111111

