NO textures/NTEX.xpm
SO textures/STEX.xpm
WE textures/WTEX.xpm
EA textures/ETEX.xpm

F 20,20,20
C 200,200,200


11111
1S001
11111

1